date,new_cases,total_cases,deaths,dhaka_cases,recovery,source
2022-01-01,6,6,0,3,5,DGHS_estimated
2022-01-02,11,17,0,4,10,DGHS_estimated
2022-01-03,5,22,0,2,4,DGHS_estimated
2022-01-04,5,27,0,2,4,DGHS_estimated
2022-01-05,14,41,0,6,13,DGHS_estimated
2022-01-06,5,46,0,2,4,DGHS_estimated
2022-01-07,11,57,0,5,10,DGHS_estimated
2022-01-08,12,69,0,5,11,DGHS_estimated
2022-01-09,11,80,0,6,10,DGHS_estimated
2022-01-10,12,92,0,6,11,DGHS_estimated
2022-01-11,11,103,0,4,10,DGHS_estimated
2022-01-12,6,109,0,3,5,DGHS_estimated
2022-01-13,14,123,0,8,13,DGHS_estimated
2022-01-14,14,137,0,6,13,DGHS_estimated
2022-01-15,6,143,0,2,5,DGHS_estimated
2022-01-16,10,153,0,4,9,DGHS_estimated
2022-01-17,14,167,0,7,13,DGHS_estimated
2022-01-18,14,181,0,6,13,DGHS_estimated
2022-01-19,10,191,0,5,9,DGHS_estimated
2022-01-20,10,201,0,4,9,DGHS_estimated
2022-01-21,6,207,0,2,5,DGHS_estimated
2022-01-22,9,216,0,4,8,DGHS_estimated
2022-01-23,5,221,0,2,4,DGHS_estimated
2022-01-24,14,235,0,8,13,DGHS_estimated
2022-01-25,5,240,0,2,4,DGHS_estimated
2022-01-26,12,252,0,7,11,DGHS_estimated
2022-01-27,8,260,0,3,7,DGHS_estimated
2022-01-28,11,271,0,4,10,DGHS_estimated
2022-01-29,5,276,0,2,4,DGHS_estimated
2022-01-30,8,284,0,4,7,DGHS_estimated
2022-01-31,5,289,0,2,4,DGHS_estimated
2022-02-01,5,294,0,2,4,DGHS_estimated
2022-02-02,12,306,0,5,11,DGHS_estimated
2022-02-03,12,318,0,5,11,DGHS_estimated
2022-02-04,11,329,0,4,10,DGHS_estimated
2022-02-05,8,337,0,4,7,DGHS_estimated
2022-02-06,12,349,0,5,11,DGHS_estimated
2022-02-07,8,357,0,3,7,DGHS_estimated
2022-02-08,7,364,0,3,6,DGHS_estimated
2022-02-09,10,374,0,5,9,DGHS_estimated
2022-02-10,9,383,0,4,8,DGHS_estimated
2022-02-11,14,397,0,7,13,DGHS_estimated
2022-02-12,13,410,0,6,12,DGHS_estimated
2022-02-13,14,424,0,8,13,DGHS_estimated
2022-02-14,10,434,0,5,9,DGHS_estimated
2022-02-15,9,443,0,4,8,DGHS_estimated
2022-02-16,11,454,0,6,10,DGHS_estimated
2022-02-17,13,467,0,7,12,DGHS_estimated
2022-02-18,8,475,0,3,7,DGHS_estimated
2022-02-19,8,483,0,4,7,DGHS_estimated
2022-02-20,8,491,0,3,7,DGHS_estimated
2022-02-21,11,502,0,6,10,DGHS_estimated
2022-02-22,6,508,0,2,5,DGHS_estimated
2022-02-23,10,518,0,4,9,DGHS_estimated
2022-02-24,9,527,0,5,8,DGHS_estimated
2022-02-25,11,538,0,5,10,DGHS_estimated
2022-02-26,6,544,0,2,5,DGHS_estimated
2022-02-27,7,551,0,3,6,DGHS_estimated
2022-02-28,13,564,0,6,12,DGHS_estimated
2022-03-01,5,569,0,2,4,DGHS_estimated
2022-03-02,6,575,0,2,5,DGHS_estimated
2022-03-03,12,587,0,6,11,DGHS_estimated
2022-03-04,9,596,0,4,8,DGHS_estimated
2022-03-05,7,603,0,3,6,DGHS_estimated
2022-03-06,6,609,0,3,5,DGHS_estimated
2022-03-07,8,617,0,3,7,DGHS_estimated
2022-03-08,13,630,0,7,12,DGHS_estimated
2022-03-09,5,635,0,2,4,DGHS_estimated
2022-03-10,13,648,0,6,12,DGHS_estimated
2022-03-11,10,658,0,5,9,DGHS_estimated
2022-03-12,6,664,0,2,5,DGHS_estimated
2022-03-13,7,671,0,3,6,DGHS_estimated
2022-03-14,9,680,0,4,8,DGHS_estimated
2022-03-15,11,691,0,6,10,DGHS_estimated
2022-03-16,13,704,0,7,12,DGHS_estimated
2022-03-17,9,713,0,3,8,DGHS_estimated
2022-03-18,12,725,0,6,11,DGHS_estimated
2022-03-19,6,731,0,2,5,DGHS_estimated
2022-03-20,5,736,0,2,4,DGHS_estimated
2022-03-21,8,744,0,4,7,DGHS_estimated
2022-03-22,8,752,0,3,7,DGHS_estimated
2022-03-23,13,765,0,6,12,DGHS_estimated
2022-03-24,6,771,0,2,5,DGHS_estimated
2022-03-25,8,779,0,4,7,DGHS_estimated
2022-03-26,12,791,0,4,11,DGHS_estimated
2022-03-27,13,804,0,7,12,DGHS_estimated
2022-03-28,7,811,0,3,6,DGHS_estimated
2022-03-29,14,825,0,6,13,DGHS_estimated
2022-03-30,11,836,0,5,10,DGHS_estimated
2022-03-31,11,847,0,5,10,DGHS_estimated
2022-04-01,30,877,0,16,28,DGHS_estimated
2022-04-02,37,914,0,20,35,DGHS_estimated
2022-04-03,35,949,0,15,33,DGHS_estimated
2022-04-04,24,973,0,11,23,DGHS_estimated
2022-04-05,13,986,0,5,12,DGHS_estimated
2022-04-06,23,1009,0,13,22,DGHS_estimated
2022-04-07,23,1032,0,11,22,DGHS_estimated
2022-04-08,25,1057,0,10,24,DGHS_estimated
2022-04-09,21,1078,0,10,20,DGHS_estimated
2022-04-10,13,1091,0,6,12,DGHS_estimated
2022-04-11,36,1127,0,19,35,DGHS_estimated
2022-04-12,37,1164,0,18,35,DGHS_estimated
2022-04-13,25,1189,0,14,24,DGHS_estimated
2022-04-14,23,1212,0,13,22,DGHS_estimated
2022-04-15,13,1225,0,7,12,DGHS_estimated
2022-04-16,23,1248,0,9,22,DGHS_estimated
2022-04-17,25,1273,0,11,23,DGHS_estimated
2022-04-18,18,1291,0,9,17,DGHS_estimated
2022-04-19,30,1321,0,15,28,DGHS_estimated
2022-04-20,15,1336,0,8,14,DGHS_estimated
2022-04-21,30,1366,0,13,28,DGHS_estimated
2022-04-22,13,1379,0,6,12,DGHS_estimated
2022-04-23,19,1398,0,10,18,DGHS_estimated
2022-04-24,20,1418,0,9,19,DGHS_estimated
2022-04-25,33,1451,0,17,32,DGHS_estimated
2022-04-26,35,1486,0,18,33,DGHS_estimated
2022-04-27,24,1510,0,12,22,DGHS_estimated
2022-04-28,33,1543,0,17,32,DGHS_estimated
2022-04-29,30,1573,0,14,29,DGHS_estimated
2022-04-30,36,1609,0,20,34,DGHS_estimated
2022-05-01,55,1664,0,28,53,DGHS_estimated
2022-05-02,59,1723,0,25,57,DGHS_estimated
2022-05-03,32,1755,0,14,30,DGHS_estimated
2022-05-04,43,1798,0,18,41,DGHS_estimated
2022-05-05,46,1844,0,26,44,DGHS_estimated
2022-05-06,50,1894,0,27,48,DGHS_estimated
2022-05-07,57,1951,0,30,55,DGHS_estimated
2022-05-08,57,2008,0,31,55,DGHS_estimated
2022-05-09,34,2042,0,15,32,DGHS_estimated
2022-05-10,40,2082,0,17,38,DGHS_estimated
2022-05-11,36,2118,0,17,34,DGHS_estimated
2022-05-12,23,2141,0,11,21,DGHS_estimated
2022-05-13,41,2182,0,22,39,DGHS_estimated
2022-05-14,57,2239,0,26,55,DGHS_estimated
2022-05-15,20,2259,0,8,19,DGHS_estimated
2022-05-16,57,2316,0,33,54,DGHS_estimated
2022-05-17,30,2346,0,16,29,DGHS_estimated
2022-05-18,36,2382,0,17,34,DGHS_estimated
2022-05-19,55,2437,0,29,52,DGHS_estimated
2022-05-20,23,2460,0,11,21,DGHS_estimated
2022-05-21,54,2514,0,27,51,DGHS_estimated
2022-05-22,50,2564,0,21,48,DGHS_estimated
2022-05-23,48,2612,0,22,46,DGHS_estimated
2022-05-24,45,2657,0,22,42,DGHS_estimated
2022-05-25,59,2716,0,30,57,DGHS_estimated
2022-05-26,45,2761,0,26,43,DGHS_estimated
2022-05-27,21,2782,0,11,20,DGHS_estimated
2022-05-28,36,2818,0,18,34,DGHS_estimated
2022-05-29,38,2856,0,20,37,DGHS_estimated
2022-05-30,22,2878,0,10,21,DGHS_estimated
2022-05-31,58,2936,0,27,55,DGHS_estimated
2022-06-01,108,3044,0,62,102,DGHS_estimated
2022-06-02,92,3136,0,37,88,DGHS_estimated
2022-06-03,76,3212,0,41,74,DGHS_estimated
2022-06-04,91,3303,0,41,86,DGHS_estimated
2022-06-05,44,3347,0,17,42,DGHS_estimated
2022-06-06,42,3389,0,21,40,DGHS_estimated
2022-06-07,48,3437,0,26,46,DGHS_estimated
2022-06-08,43,3480,0,18,41,DGHS_estimated
2022-06-09,45,3525,0,26,43,DGHS_estimated
2022-06-10,41,3566,0,23,39,DGHS_estimated
2022-06-11,57,3623,0,29,54,DGHS_estimated
2022-06-12,58,3681,0,30,55,DGHS_estimated
2022-06-13,105,3786,0,62,100,DGHS_estimated
2022-06-14,70,3856,0,28,68,DGHS_estimated
2022-06-15,40,3896,0,23,38,DGHS_estimated
2022-06-16,57,3953,0,27,55,DGHS_estimated
2022-06-17,45,3998,0,18,43,DGHS_estimated
2022-06-18,63,4061,0,33,61,DGHS_estimated
2022-06-19,112,4173,0,57,107,DGHS_estimated
2022-06-20,52,4225,0,28,50,DGHS_estimated
2022-06-21,91,4316,0,47,88,DGHS_estimated
2022-06-22,92,4408,0,54,87,DGHS_estimated
2022-06-23,73,4481,0,31,71,DGHS_estimated
2022-06-24,108,4589,0,60,104,DGHS_estimated
2022-06-25,47,4636,0,27,45,DGHS_estimated
2022-06-26,116,4752,0,66,111,DGHS_estimated
2022-06-27,102,4854,0,53,98,DGHS_estimated
2022-06-28,118,4972,0,67,115,DGHS_estimated
2022-06-29,95,5067,0,46,92,DGHS_estimated
2022-06-30,60,5127,0,30,58,DGHS_estimated
2022-07-01,130,5257,0,77,126,DGHS_estimated
2022-07-02,54,5311,0,27,52,DGHS_estimated
2022-07-03,106,5417,0,54,103,DGHS_estimated
2022-07-04,74,5491,0,42,72,DGHS_estimated
2022-07-05,58,5549,0,25,55,DGHS_estimated
2022-07-06,113,5662,0,47,110,DGHS_estimated
2022-07-07,125,5787,0,58,119,DGHS_estimated
2022-07-08,55,5842,0,30,53,DGHS_estimated
2022-07-09,60,5902,0,27,57,DGHS_estimated
2022-07-10,107,6009,0,58,103,DGHS_estimated
2022-07-11,147,6156,0,72,140,DGHS_estimated
2022-07-12,85,6241,0,40,80,DGHS_estimated
2022-07-13,62,6303,0,33,60,DGHS_estimated
2022-07-14,124,6427,0,62,118,DGHS_estimated
2022-07-15,83,6510,0,39,80,DGHS_estimated
2022-07-16,136,6646,0,68,130,DGHS_estimated
2022-07-17,143,6789,0,82,138,DGHS_estimated
2022-07-18,138,6927,0,70,134,DGHS_estimated
2022-07-19,123,7050,0,65,118,DGHS_estimated
2022-07-20,90,7140,0,50,88,DGHS_estimated
2022-07-21,109,7249,0,62,104,DGHS_estimated
2022-07-22,130,7379,0,65,125,DGHS_estimated
2022-07-23,99,7478,0,43,94,DGHS_estimated
2022-07-24,63,7541,0,27,61,DGHS_estimated
2022-07-25,77,7618,0,32,73,DGHS_estimated
2022-07-26,110,7728,0,57,106,DGHS_estimated
2022-07-27,118,7846,0,53,115,DGHS_estimated
2022-07-28,115,7961,0,62,110,DGHS_estimated
2022-07-29,74,8035,0,30,70,DGHS_estimated
2022-07-30,130,8165,0,58,125,DGHS_estimated
2022-07-31,149,8314,0,69,144,DGHS_estimated
2022-08-01,71,8385,0,32,67,DGHS_estimated
2022-08-02,105,8490,0,50,101,DGHS_estimated
2022-08-03,82,8572,0,43,79,DGHS_estimated
2022-08-04,176,8748,0,104,172,DGHS_estimated
2022-08-05,79,8827,0,45,76,DGHS_estimated
2022-08-06,116,8943,0,54,110,DGHS_estimated
2022-08-07,128,9071,0,76,121,DGHS_estimated
2022-08-08,155,9226,0,87,151,DGHS_estimated
2022-08-09,143,9369,0,64,139,DGHS_estimated
2022-08-10,64,9433,0,32,61,DGHS_estimated
2022-08-11,81,9514,0,33,78,DGHS_estimated
2022-08-12,169,9683,0,80,163,DGHS_estimated
2022-08-13,97,9780,0,47,93,DGHS_estimated
2022-08-14,100,9880,0,49,96,DGHS_estimated
2022-08-15,87,9967,0,39,82,DGHS_estimated
2022-08-16,157,10124,0,77,149,DGHS_estimated
2022-08-17,69,10193,0,28,66,DGHS_estimated
2022-08-18,87,10280,0,47,83,DGHS_estimated
2022-08-19,79,10359,0,43,75,DGHS_estimated
2022-08-20,73,10432,0,36,70,DGHS_estimated
2022-08-21,147,10579,0,68,140,DGHS_estimated
2022-08-22,111,10690,0,53,107,DGHS_estimated
2022-08-23,96,10786,0,39,92,DGHS_estimated
2022-08-24,170,10956,0,100,164,DGHS_estimated
2022-08-25,157,11113,0,68,150,DGHS_estimated
2022-08-26,120,11233,0,54,117,DGHS_estimated
2022-08-27,177,11410,0,103,168,DGHS_estimated
2022-08-28,173,11583,0,86,168,DGHS_estimated
2022-08-29,125,11708,0,68,120,DGHS_estimated
2022-08-30,60,11768,0,28,58,DGHS_estimated
2022-08-31,61,11829,0,34,57,DGHS_estimated
2022-09-01,140,11969,0,60,135,DGHS_estimated
2022-09-02,145,12114,0,77,140,DGHS_estimated
2022-09-03,191,12305,0,86,185,DGHS_estimated
2022-09-04,155,12460,0,83,148,DGHS_estimated
2022-09-05,76,12536,0,42,72,DGHS_estimated
2022-09-06,202,12738,0,107,193,DGHS_estimated
2022-09-07,110,12848,0,51,105,DGHS_estimated
2022-09-08,169,13017,0,87,162,DGHS_estimated
2022-09-09,102,13119,0,57,97,DGHS_estimated
2022-09-10,79,13198,0,46,75,DGHS_estimated
2022-09-11,157,13355,0,78,153,DGHS_estimated
2022-09-12,114,13469,0,54,108,DGHS_estimated
2022-09-13,101,13570,0,46,97,DGHS_estimated
2022-09-14,85,13655,0,40,82,DGHS_estimated
2022-09-15,163,13818,0,97,156,DGHS_estimated
2022-09-16,197,14015,0,117,188,DGHS_estimated
2022-09-17,81,14096,0,45,77,DGHS_estimated
2022-09-18,108,14204,0,51,103,DGHS_estimated
2022-09-19,74,14278,0,36,71,DGHS_estimated
2022-09-20,94,14372,0,44,91,DGHS_estimated
2022-09-21,162,14534,0,94,158,DGHS_estimated
2022-09-22,123,14657,0,55,116,DGHS_estimated
2022-09-23,166,14823,0,69,160,DGHS_estimated
2022-09-24,91,14914,0,47,89,DGHS_estimated
2022-09-25,73,14987,0,43,69,DGHS_estimated
2022-09-26,93,15080,0,39,88,DGHS_estimated
2022-09-27,166,15246,0,92,162,DGHS_estimated
2022-09-28,193,15439,0,94,185,DGHS_estimated
2022-09-29,116,15555,0,68,113,DGHS_estimated
2022-09-30,103,15658,0,59,99,DGHS_estimated
2022-10-01,56,15714,0,27,53,DGHS_estimated
2022-10-02,53,15767,0,30,50,DGHS_estimated
2022-10-03,56,15823,0,29,53,DGHS_estimated
2022-10-04,57,15880,0,27,54,DGHS_estimated
2022-10-05,37,15917,0,16,35,DGHS_estimated
2022-10-06,59,15976,0,24,57,DGHS_estimated
2022-10-07,49,16025,0,21,47,DGHS_estimated
2022-10-08,43,16068,0,25,40,DGHS_estimated
2022-10-09,21,16089,0,12,20,DGHS_estimated
2022-10-10,52,16141,0,24,49,DGHS_estimated
2022-10-11,22,16163,0,10,21,DGHS_estimated
2022-10-12,22,16185,0,12,21,DGHS_estimated
2022-10-13,55,16240,0,31,53,DGHS_estimated
2022-10-14,48,16288,0,22,46,DGHS_estimated
2022-10-15,26,16314,0,10,24,DGHS_estimated
2022-10-16,23,16337,0,10,21,DGHS_estimated
2022-10-17,58,16395,0,26,56,DGHS_estimated
2022-10-18,42,16437,0,20,40,DGHS_estimated
2022-10-19,30,16467,0,14,29,DGHS_estimated
2022-10-20,50,16517,0,29,47,DGHS_estimated
2022-10-21,27,16544,0,14,26,DGHS_estimated
2022-10-22,35,16579,0,15,33,DGHS_estimated
2022-10-23,58,16637,0,24,56,DGHS_estimated
2022-10-24,51,16688,0,25,48,DGHS_estimated
2022-10-25,44,16732,0,23,42,DGHS_estimated
2022-10-26,24,16756,0,14,22,DGHS_estimated
2022-10-27,45,16801,0,21,44,DGHS_estimated
2022-10-28,36,16837,0,18,34,DGHS_estimated
2022-10-29,30,16867,0,17,29,DGHS_estimated
2022-10-30,44,16911,0,21,42,DGHS_estimated
2022-10-31,58,16969,0,32,56,DGHS_estimated
2022-11-01,23,16992,0,11,22,DGHS_estimated
2022-11-02,28,17020,0,14,27,DGHS_estimated
2022-11-03,24,17044,0,14,23,DGHS_estimated
2022-11-04,24,17068,0,13,23,DGHS_estimated
2022-11-05,20,17088,0,8,19,DGHS_estimated
2022-11-06,24,17112,0,13,23,DGHS_estimated
2022-11-07,24,17136,0,14,22,DGHS_estimated
2022-11-08,22,17158,0,11,21,DGHS_estimated
2022-11-09,14,17172,0,6,13,DGHS_estimated
2022-11-10,18,17190,0,7,17,DGHS_estimated
2022-11-11,24,17214,0,12,22,DGHS_estimated
2022-11-12,13,17227,0,7,12,DGHS_estimated
2022-11-13,34,17261,0,17,32,DGHS_estimated
2022-11-14,21,17282,0,11,20,DGHS_estimated
2022-11-15,27,17309,0,11,25,DGHS_estimated
2022-11-16,23,17332,0,12,22,DGHS_estimated
2022-11-17,30,17362,0,16,29,DGHS_estimated
2022-11-18,14,17376,0,7,13,DGHS_estimated
2022-11-19,32,17408,0,16,31,DGHS_estimated
2022-11-20,30,17438,0,13,29,DGHS_estimated
2022-11-21,29,17467,0,13,27,DGHS_estimated
2022-11-22,16,17483,0,8,15,DGHS_estimated
2022-11-23,17,17500,0,7,16,DGHS_estimated
2022-11-24,35,17535,0,19,34,DGHS_estimated
2022-11-25,25,17560,0,13,23,DGHS_estimated
2022-11-26,30,17590,0,12,29,DGHS_estimated
2022-11-27,29,17619,0,15,27,DGHS_estimated
2022-11-28,36,17655,0,15,34,DGHS_estimated
2022-11-29,14,17669,0,5,13,DGHS_estimated
2022-11-30,20,17689,0,8,19,DGHS_estimated
2022-12-01,9,17698,0,5,8,DGHS_estimated
2022-12-02,11,17709,0,5,10,DGHS_estimated
2022-12-03,5,17714,0,2,4,DGHS_estimated
2022-12-04,13,17727,0,5,12,DGHS_estimated
2022-12-05,8,17735,0,4,7,DGHS_estimated
2022-12-06,7,17742,0,4,6,DGHS_estimated
2022-12-07,10,17752,0,4,9,DGHS_estimated
2022-12-08,7,17759,0,3,6,DGHS_estimated
2022-12-09,14,17773,0,6,13,DGHS_estimated
2022-12-10,9,17782,0,4,8,DGHS_estimated
2022-12-11,5,17787,0,2,4,DGHS_estimated
2022-12-12,5,17792,0,2,4,DGHS_estimated
2022-12-13,11,17803,0,5,10,DGHS_estimated
2022-12-14,8,17811,0,4,7,DGHS_estimated
2022-12-15,11,17822,0,5,10,DGHS_estimated
2022-12-16,5,17827,0,2,4,DGHS_estimated
2022-12-17,13,17840,0,6,12,DGHS_estimated
2022-12-18,10,17850,0,5,9,DGHS_estimated
2022-12-19,8,17858,0,3,7,DGHS_estimated
2022-12-20,7,17865,0,3,6,DGHS_estimated
2022-12-21,9,17874,0,4,8,DGHS_estimated
2022-12-22,10,17884,0,4,9,DGHS_estimated
2022-12-23,5,17889,0,2,4,DGHS_estimated
2022-12-24,7,17896,0,3,6,DGHS_estimated
2022-12-25,7,17903,0,3,6,DGHS_estimated
2022-12-26,7,17910,0,3,6,DGHS_estimated
2022-12-27,6,17916,0,3,5,DGHS_estimated
2022-12-28,8,17924,0,4,7,DGHS_estimated
2022-12-29,11,17935,0,5,10,DGHS_estimated
2022-12-30,12,17947,0,6,11,DGHS_estimated
2022-12-31,12,17959,0,6,11,DGHS_estimated
2023-01-01,16,17975,0,7,15,DGHS_estimated
2023-01-02,20,17995,0,11,19,DGHS_estimated
2023-01-03,9,18004,0,4,8,DGHS_estimated
2023-01-04,14,18018,0,6,13,DGHS_estimated
2023-01-05,10,18028,0,5,9,DGHS_estimated
2023-01-06,11,18039,0,6,10,DGHS_estimated
2023-01-07,22,18061,0,12,21,DGHS_estimated
2023-01-08,19,18080,0,10,18,DGHS_estimated
2023-01-09,13,18093,0,5,12,DGHS_estimated
2023-01-10,12,18105,0,5,11,DGHS_estimated
2023-01-11,8,18113,0,3,7,DGHS_estimated
2023-01-12,18,18131,0,7,17,DGHS_estimated
2023-01-13,13,18144,0,7,12,DGHS_estimated
2023-01-14,21,18165,0,11,20,DGHS_estimated
2023-01-15,9,18174,0,5,8,DGHS_estimated
2023-01-16,14,18188,0,7,13,DGHS_estimated
2023-01-17,22,18210,0,9,21,DGHS_estimated
2023-01-18,20,18230,0,8,19,DGHS_estimated
2023-01-19,15,18245,0,7,14,DGHS_estimated
2023-01-20,8,18253,0,3,7,DGHS_estimated
2023-01-21,15,18268,0,6,14,DGHS_estimated
2023-01-22,11,18279,0,5,10,DGHS_estimated
2023-01-23,11,18290,0,4,10,DGHS_estimated
2023-01-24,18,18308,0,8,17,DGHS_estimated
2023-01-25,17,18325,0,8,16,DGHS_estimated
2023-01-26,14,18339,0,6,13,DGHS_estimated
2023-01-27,12,18351,0,4,11,DGHS_estimated
2023-01-28,13,18364,0,6,12,DGHS_estimated
2023-01-29,21,18385,0,9,20,DGHS_estimated
2023-01-30,16,18401,0,9,15,DGHS_estimated
2023-01-31,10,18411,0,5,9,DGHS_estimated
2023-02-01,15,18426,0,7,14,DGHS_estimated
2023-02-02,12,18438,0,6,11,DGHS_estimated
2023-02-03,18,18456,0,7,17,DGHS_estimated
2023-02-04,9,18465,0,5,8,DGHS_estimated
2023-02-05,15,18480,0,6,14,DGHS_estimated
2023-02-06,13,18493,0,6,12,DGHS_estimated
2023-02-07,15,18508,0,7,14,DGHS_estimated
2023-02-08,20,18528,0,9,19,DGHS_estimated
2023-02-09,9,18537,0,3,8,DGHS_estimated
2023-02-10,16,18553,0,7,15,DGHS_estimated
2023-02-11,15,18568,0,6,14,DGHS_estimated
2023-02-12,14,18582,0,7,13,DGHS_estimated
2023-02-13,12,18594,0,5,11,DGHS_estimated
2023-02-14,11,18605,0,6,10,DGHS_estimated
2023-02-15,21,18626,0,9,20,DGHS_estimated
2023-02-16,19,18645,0,10,18,DGHS_estimated
2023-02-17,10,18655,0,4,9,DGHS_estimated
2023-02-18,21,18676,0,10,20,DGHS_estimated
2023-02-19,18,18694,0,7,17,DGHS_estimated
2023-02-20,8,18702,0,3,7,DGHS_estimated
2023-02-21,21,18723,0,10,20,DGHS_estimated
2023-02-22,12,18735,0,5,11,DGHS_estimated
2023-02-23,17,18752,0,7,16,DGHS_estimated
2023-02-24,20,18772,0,10,19,DGHS_estimated
2023-02-25,15,18787,0,6,14,DGHS_estimated
2023-02-26,20,18807,0,8,19,DGHS_estimated
2023-02-27,16,18823,0,8,15,DGHS_estimated
2023-02-28,14,18837,0,7,13,DGHS_estimated
2023-03-01,17,18854,0,9,16,DGHS_estimated
2023-03-02,16,18870,0,7,15,DGHS_estimated
2023-03-03,18,18888,0,10,17,DGHS_estimated
2023-03-04,8,18896,0,3,7,DGHS_estimated
2023-03-05,13,18909,0,6,12,DGHS_estimated
2023-03-06,16,18925,0,7,15,DGHS_estimated
2023-03-07,14,18939,0,6,13,DGHS_estimated
2023-03-08,20,18959,0,11,19,DGHS_estimated
2023-03-09,17,18976,0,9,16,DGHS_estimated
2023-03-10,22,18998,0,10,21,DGHS_estimated
2023-03-11,13,19011,0,7,12,DGHS_estimated
2023-03-12,16,19027,0,7,15,DGHS_estimated
2023-03-13,16,19043,0,6,15,DGHS_estimated
2023-03-14,8,19051,0,4,7,DGHS_estimated
2023-03-15,8,19059,0,3,7,DGHS_estimated
2023-03-16,13,19072,0,6,12,DGHS_estimated
2023-03-17,13,19085,0,6,12,DGHS_estimated
2023-03-18,19,19104,0,8,18,DGHS_estimated
2023-03-19,16,19120,0,7,15,DGHS_estimated
2023-03-20,9,19129,0,3,8,DGHS_estimated
2023-03-21,13,19142,0,7,12,DGHS_estimated
2023-03-22,13,19155,0,7,12,DGHS_estimated
2023-03-23,20,19175,0,11,19,DGHS_estimated
2023-03-24,9,19184,0,4,8,DGHS_estimated
2023-03-25,9,19193,0,4,8,DGHS_estimated
2023-03-26,21,19214,0,10,20,DGHS_estimated
2023-03-27,7,19221,0,3,6,DGHS_estimated
2023-03-28,22,19243,0,9,20,DGHS_estimated
2023-03-29,7,19250,0,2,6,DGHS_estimated
2023-03-30,13,19263,0,7,12,DGHS_estimated
2023-03-31,22,19285,0,11,21,DGHS_estimated
2023-04-01,27,19312,0,15,26,DGHS_estimated
2023-04-02,48,19360,0,27,46,DGHS_estimated
2023-04-03,28,19388,0,16,27,DGHS_estimated
2023-04-04,20,19408,0,9,19,DGHS_estimated
2023-04-05,55,19463,0,26,53,DGHS_estimated
2023-04-06,28,19491,0,15,27,DGHS_estimated
2023-04-07,39,19530,0,17,37,DGHS_estimated
2023-04-08,28,19558,0,15,26,DGHS_estimated
2023-04-09,34,19592,0,18,32,DGHS_estimated
2023-04-10,25,19617,0,12,23,DGHS_estimated
2023-04-11,22,19639,0,8,21,DGHS_estimated
2023-04-12,31,19670,0,14,29,DGHS_estimated
2023-04-13,46,19716,0,21,44,DGHS_estimated
2023-04-14,31,19747,0,13,29,DGHS_estimated
2023-04-15,47,19794,0,24,45,DGHS_estimated
2023-04-16,36,19830,0,20,35,DGHS_estimated
2023-04-17,42,19872,0,17,40,DGHS_estimated
2023-04-18,41,19913,0,21,39,DGHS_estimated
2023-04-19,25,19938,0,14,24,DGHS_estimated
2023-04-20,53,19991,0,24,51,DGHS_estimated
2023-04-21,25,20016,0,14,24,DGHS_estimated
2023-04-22,52,20068,0,24,49,DGHS_estimated
2023-04-23,20,20088,0,11,19,DGHS_estimated
2023-04-24,24,20112,0,12,23,DGHS_estimated
2023-04-25,38,20150,0,20,37,DGHS_estimated
2023-04-26,37,20187,0,16,36,DGHS_estimated
2023-04-27,33,20220,0,15,31,DGHS_estimated
2023-04-28,28,20248,0,15,26,DGHS_estimated
2023-04-29,47,20295,0,22,44,DGHS_estimated
2023-04-30,33,20328,0,19,31,DGHS_estimated
2023-05-01,63,20391,0,31,59,DGHS_estimated
2023-05-02,64,20455,0,26,61,DGHS_estimated
2023-05-03,62,20517,0,36,59,DGHS_estimated
2023-05-04,73,20590,0,38,70,DGHS_estimated
2023-05-05,46,20636,0,26,43,DGHS_estimated
2023-05-06,30,20666,0,17,29,DGHS_estimated
2023-05-07,58,20724,0,24,56,DGHS_estimated
2023-05-08,87,20811,0,45,85,DGHS_estimated
2023-05-09,60,20871,0,30,57,DGHS_estimated
2023-05-10,42,20913,0,23,40,DGHS_estimated
2023-05-11,76,20989,0,32,74,DGHS_estimated
2023-05-12,49,21038,0,26,47,DGHS_estimated
2023-05-13,55,21093,0,25,53,DGHS_estimated
2023-05-14,85,21178,0,36,81,DGHS_estimated
2023-05-15,55,21233,0,30,53,DGHS_estimated
2023-05-16,77,21310,0,38,74,DGHS_estimated
2023-05-17,33,21343,0,13,32,DGHS_estimated
2023-05-18,71,21414,0,37,68,DGHS_estimated
2023-05-19,52,21466,0,29,50,DGHS_estimated
2023-05-20,45,21511,0,26,43,DGHS_estimated
2023-05-21,52,21563,0,21,50,DGHS_estimated
2023-05-22,51,21614,0,28,48,DGHS_estimated
2023-05-23,82,21696,0,40,79,DGHS_estimated
2023-05-24,72,21768,0,36,69,DGHS_estimated
2023-05-25,87,21855,0,50,83,DGHS_estimated
2023-05-26,59,21914,0,30,56,DGHS_estimated
2023-05-27,50,21964,0,29,48,DGHS_estimated
2023-05-28,38,22002,0,20,36,DGHS_estimated
2023-05-29,84,22086,0,37,80,DGHS_estimated
2023-05-30,85,22171,0,40,82,DGHS_estimated
2023-05-31,82,22253,0,45,79,DGHS_estimated
2023-06-01,124,22377,0,65,119,DGHS_estimated
2023-06-02,168,22545,0,97,163,DGHS_estimated
2023-06-03,61,22606,0,35,59,DGHS_estimated
2023-06-04,86,22692,0,47,81,DGHS_estimated
2023-06-05,108,22800,0,50,103,DGHS_estimated
2023-06-06,156,22956,0,90,148,DGHS_estimated
2023-06-07,163,23119,0,94,155,DGHS_estimated
2023-06-08,139,23258,0,77,134,DGHS_estimated
2023-06-09,161,23419,0,74,155,DGHS_estimated
2023-06-10,93,23512,0,55,89,DGHS_estimated
2023-06-11,134,23646,0,76,130,DGHS_estimated
2023-06-12,76,23722,0,33,73,DGHS_estimated
2023-06-13,159,23881,0,89,153,DGHS_estimated
2023-06-14,151,24032,0,73,147,DGHS_estimated
2023-06-15,139,24171,0,56,134,DGHS_estimated
2023-06-16,95,24266,0,51,92,DGHS_estimated
2023-06-17,140,24406,0,72,136,DGHS_estimated
2023-06-18,111,24517,0,46,107,DGHS_estimated
2023-06-19,150,24667,0,60,145,DGHS_estimated
2023-06-20,97,24764,0,52,93,DGHS_estimated
2023-06-21,157,24921,0,75,151,DGHS_estimated
2023-06-22,119,25040,0,69,113,DGHS_estimated
2023-06-23,135,25175,0,68,131,DGHS_estimated
2023-06-24,164,25339,0,93,159,DGHS_estimated
2023-06-25,171,25510,0,78,165,DGHS_estimated
2023-06-26,68,25578,0,34,66,DGHS_estimated
2023-06-27,145,25723,0,85,138,DGHS_estimated
2023-06-28,98,25821,0,43,95,DGHS_estimated
2023-06-29,115,25936,0,47,110,DGHS_estimated
2023-06-30,126,26062,0,57,122,DGHS_estimated
2023-07-01,90,26152,0,46,85,DGHS_estimated
2023-07-02,220,26372,0,101,213,DGHS_estimated
2023-07-03,165,26537,0,70,159,DGHS_estimated
2023-07-04,106,26643,0,51,102,DGHS_estimated
2023-07-05,96,26739,0,52,93,DGHS_estimated
2023-07-06,163,26902,0,84,156,DGHS_estimated
2023-07-07,135,27037,0,63,129,DGHS_estimated
2023-07-08,75,27112,0,32,71,DGHS_estimated
2023-07-09,100,27212,0,57,96,DGHS_estimated
2023-07-10,183,27395,0,85,177,DGHS_estimated
2023-07-11,86,27481,0,38,82,DGHS_estimated
2023-07-12,176,27657,0,102,170,DGHS_estimated
2023-07-13,127,27784,0,50,123,DGHS_estimated
2023-07-14,88,27872,0,50,84,DGHS_estimated
2023-07-15,186,28058,0,106,176,DGHS_estimated
2023-07-16,175,28233,0,86,168,DGHS_estimated
2023-07-17,189,28422,0,109,184,DGHS_estimated
2023-07-18,93,28515,0,42,90,DGHS_estimated
2023-07-19,189,28704,0,76,180,DGHS_estimated
2023-07-20,106,28810,0,44,101,DGHS_estimated
2023-07-21,85,28895,0,35,81,DGHS_estimated
2023-07-22,173,29068,0,92,167,DGHS_estimated
2023-07-23,186,29254,0,97,179,DGHS_estimated
2023-07-24,214,29468,0,114,208,DGHS_estimated
2023-07-25,87,29555,0,36,84,DGHS_estimated
2023-07-26,198,29753,0,91,190,DGHS_estimated
2023-07-27,108,29861,0,50,104,DGHS_estimated
2023-07-28,93,29954,0,53,89,DGHS_estimated
2023-07-29,159,30113,0,74,154,DGHS_estimated
2023-07-30,96,30209,0,41,91,DGHS_estimated
2023-07-31,195,30404,0,106,188,DGHS_estimated
2023-08-01,90,30494,0,50,86,DGHS_estimated
2023-08-02,223,30717,0,123,216,DGHS_estimated
2023-08-03,243,30960,1,110,234,DGHS_estimated
2023-08-04,107,31067,0,47,103,DGHS_estimated
2023-08-05,154,31221,0,67,148,DGHS_estimated
2023-08-06,219,31440,0,88,213,DGHS_estimated
2023-08-07,242,31682,1,125,232,DGHS_estimated
2023-08-08,132,31814,0,78,126,DGHS_estimated
2023-08-09,177,31991,0,81,171,DGHS_estimated
2023-08-10,124,32115,0,49,119,DGHS_estimated
2023-08-11,200,32315,0,109,195,DGHS_estimated
2023-08-12,114,32429,0,49,108,DGHS_estimated
2023-08-13,130,32559,0,72,127,DGHS_estimated
2023-08-14,91,32650,0,42,88,DGHS_estimated
2023-08-15,186,32836,0,93,181,DGHS_estimated
2023-08-16,92,32928,0,53,88,DGHS_estimated
2023-08-17,193,33121,0,92,188,DGHS_estimated
2023-08-18,266,33387,1,148,253,DGHS_estimated
2023-08-19,180,33567,0,101,175,DGHS_estimated
2023-08-20,253,33820,0,130,246,DGHS_estimated
2023-08-21,122,33942,0,62,119,DGHS_estimated
2023-08-22,129,34071,0,53,122,DGHS_estimated
2023-08-23,263,34334,0,135,249,DGHS_estimated
2023-08-24,134,34468,0,71,130,DGHS_estimated
2023-08-25,202,34670,0,99,196,DGHS_estimated
2023-08-26,99,34769,0,54,96,DGHS_estimated
2023-08-27,250,35019,1,143,239,DGHS_estimated
2023-08-28,164,35183,0,74,158,DGHS_estimated
2023-08-29,211,35394,0,125,202,DGHS_estimated
2023-08-30,156,35550,0,80,149,DGHS_estimated
2023-08-31,201,35751,0,101,191,DGHS_estimated
2023-09-01,129,35880,0,58,125,DGHS_estimated
2023-09-02,111,35991,0,54,108,DGHS_estimated
2023-09-03,201,36192,0,92,191,DGHS_estimated
2023-09-04,297,36489,0,165,286,DGHS_estimated
2023-09-05,312,36801,1,174,299,DGHS_estimated
2023-09-06,286,37087,0,123,276,DGHS_estimated
2023-09-07,265,37352,1,113,257,DGHS_estimated
2023-09-08,280,37632,0,147,274,DGHS_estimated
2023-09-09,213,37845,0,98,207,DGHS_estimated
2023-09-10,309,38154,1,168,300,DGHS_estimated
2023-09-11,269,38423,1,151,256,DGHS_estimated
2023-09-12,242,38665,0,115,235,DGHS_estimated
2023-09-13,256,38921,0,140,249,DGHS_estimated
2023-09-14,192,39113,0,105,184,DGHS_estimated
2023-09-15,220,39333,0,89,209,DGHS_estimated
2023-09-16,168,39501,0,78,160,DGHS_estimated
2023-09-17,158,39659,0,88,151,DGHS_estimated
2023-09-18,148,39807,0,65,140,DGHS_estimated
2023-09-19,161,39968,0,68,157,DGHS_estimated
2023-09-20,152,40120,0,82,145,DGHS_estimated
2023-09-21,297,40417,0,170,285,DGHS_estimated
2023-09-22,296,40713,0,170,281,DGHS_estimated
2023-09-23,237,40950,0,123,230,DGHS_estimated
2023-09-24,179,41129,0,90,171,DGHS_estimated
2023-09-25,122,41251,0,62,116,DGHS_estimated
2023-09-26,207,41458,0,85,202,DGHS_estimated
2023-09-27,222,41680,0,92,211,DGHS_estimated
2023-09-28,235,41915,0,113,224,DGHS_estimated
2023-09-29,118,42033,0,66,113,DGHS_estimated
2023-09-30,314,42347,1,181,299,DGHS_estimated
2023-10-01,47,42394,0,26,44,DGHS_estimated
2023-10-02,38,42432,0,22,36,DGHS_estimated
2023-10-03,76,42508,0,43,72,DGHS_estimated
2023-10-04,84,42592,0,39,80,DGHS_estimated
2023-10-05,81,42673,0,40,79,DGHS_estimated
2023-10-06,53,42726,0,25,50,DGHS_estimated
2023-10-07,34,42760,0,15,33,DGHS_estimated
2023-10-08,71,42831,0,41,67,DGHS_estimated
2023-10-09,63,42894,0,28,61,DGHS_estimated
2023-10-10,59,42953,0,33,56,DGHS_estimated
2023-10-11,76,43029,0,41,74,DGHS_estimated
2023-10-12,62,43091,0,36,60,DGHS_estimated
2023-10-13,76,43167,0,35,72,DGHS_estimated
2023-10-14,67,43234,0,28,63,DGHS_estimated
2023-10-15,47,43281,0,22,45,DGHS_estimated
2023-10-16,86,43367,0,48,83,DGHS_estimated
2023-10-17,78,43445,0,38,74,DGHS_estimated
2023-10-18,60,43505,0,24,57,DGHS_estimated
2023-10-19,70,43575,0,28,67,DGHS_estimated
2023-10-20,77,43652,0,40,73,DGHS_estimated
2023-10-21,35,43687,0,14,33,DGHS_estimated
2023-10-22,39,43726,0,18,37,DGHS_estimated
2023-10-23,75,43801,0,35,72,DGHS_estimated
2023-10-24,44,43845,0,24,42,DGHS_estimated
2023-10-25,69,43914,0,37,67,DGHS_estimated
2023-10-26,41,43955,0,21,39,DGHS_estimated
2023-10-27,38,43993,0,21,36,DGHS_estimated
2023-10-28,87,44080,0,35,82,DGHS_estimated
2023-10-29,64,44144,0,37,62,DGHS_estimated
2023-10-30,70,44214,0,39,68,DGHS_estimated
2023-10-31,47,44261,0,22,46,DGHS_estimated
2023-11-01,28,44289,0,14,27,DGHS_estimated
2023-11-02,53,44342,0,24,50,DGHS_estimated
2023-11-03,54,44396,0,31,51,DGHS_estimated
2023-11-04,37,44433,0,17,35,DGHS_estimated
2023-11-05,51,44484,0,28,49,DGHS_estimated
2023-11-06,47,44531,0,21,45,DGHS_estimated
2023-11-07,22,44553,0,9,20,DGHS_estimated
2023-11-08,38,44591,0,21,36,DGHS_estimated
2023-11-09,54,44645,0,25,51,DGHS_estimated
2023-11-10,44,44689,0,24,41,DGHS_estimated
2023-11-11,38,44727,0,21,36,DGHS_estimated
2023-11-12,42,44769,0,22,40,DGHS_estimated
2023-11-13,36,44805,0,20,34,DGHS_estimated
2023-11-14,30,44835,0,13,29,DGHS_estimated
2023-11-15,54,44889,0,30,52,DGHS_estimated
2023-11-16,36,44925,0,15,34,DGHS_estimated
2023-11-17,24,44949,0,12,23,DGHS_estimated
2023-11-18,54,45003,0,29,52,DGHS_estimated
2023-11-19,49,45052,0,27,47,DGHS_estimated
2023-11-20,55,45107,0,22,53,DGHS_estimated
2023-11-21,19,45126,0,8,18,DGHS_estimated
2023-11-22,36,45162,0,17,34,DGHS_estimated
2023-11-23,21,45183,0,12,20,DGHS_estimated
2023-11-24,48,45231,0,21,45,DGHS_estimated
2023-11-25,33,45264,0,16,31,DGHS_estimated
2023-11-26,55,45319,0,29,52,DGHS_estimated
2023-11-27,23,45342,0,12,21,DGHS_estimated
2023-11-28,22,45364,0,9,21,DGHS_estimated
2023-11-29,21,45385,0,11,20,DGHS_estimated
2023-11-30,38,45423,0,19,37,DGHS_estimated
2023-12-01,13,45436,0,5,12,DGHS_estimated
2023-12-02,18,45454,0,7,17,DGHS_estimated
2023-12-03,21,45475,0,8,20,DGHS_estimated
2023-12-04,7,45482,0,3,6,DGHS_estimated
2023-12-05,21,45503,0,11,20,DGHS_estimated
2023-12-06,11,45514,0,5,10,DGHS_estimated
2023-12-07,22,45536,0,9,21,DGHS_estimated
2023-12-08,11,45547,0,6,10,DGHS_estimated
2023-12-09,14,45561,0,6,13,DGHS_estimated
2023-12-10,13,45574,0,7,12,DGHS_estimated
2023-12-11,22,45596,0,13,21,DGHS_estimated
2023-12-12,12,45608,0,4,11,DGHS_estimated
2023-12-13,7,45615,0,3,6,DGHS_estimated
2023-12-14,13,45628,0,6,12,DGHS_estimated
2023-12-15,21,45649,0,10,20,DGHS_estimated
2023-12-16,10,45659,0,5,9,DGHS_estimated
2023-12-17,11,45670,0,4,10,DGHS_estimated
2023-12-18,17,45687,0,9,16,DGHS_estimated
2023-12-19,14,45701,0,6,13,DGHS_estimated
2023-12-20,9,45710,0,3,8,DGHS_estimated
2023-12-21,21,45731,0,12,20,DGHS_estimated
2023-12-22,19,45750,0,8,18,DGHS_estimated
2023-12-23,13,45763,0,6,12,DGHS_estimated
2023-12-24,11,45774,0,5,10,DGHS_estimated
2023-12-25,21,45795,0,12,20,DGHS_estimated
2023-12-26,15,45810,0,8,14,DGHS_estimated
2023-12-27,14,45824,0,7,13,DGHS_estimated
2023-12-28,13,45837,0,6,12,DGHS_estimated
2023-12-29,17,45854,0,9,16,DGHS_estimated
2023-12-30,10,45864,0,5,9,DGHS_estimated
2023-12-31,7,45871,0,3,6,DGHS_estimated
2024-01-01,6,45877,0,3,5,DGHS_estimated
2024-01-02,12,45889,0,6,11,DGHS_estimated
2024-01-03,14,45903,0,6,13,DGHS_estimated
2024-01-04,15,45918,0,7,14,DGHS_estimated
2024-01-05,16,45934,0,6,15,DGHS_estimated
2024-01-06,12,45946,0,6,11,DGHS_estimated
2024-01-07,10,45956,0,4,9,DGHS_estimated
2024-01-08,11,45967,0,5,10,DGHS_estimated
2024-01-09,17,45984,0,8,16,DGHS_estimated
2024-01-10,15,45999,0,8,14,DGHS_estimated
2024-01-11,10,46009,0,4,9,DGHS_estimated
2024-01-12,6,46015,0,3,5,DGHS_estimated
2024-01-13,6,46021,0,3,5,DGHS_estimated
2024-01-14,11,46032,0,4,10,DGHS_estimated
2024-01-15,13,46045,0,7,12,DGHS_estimated
2024-01-16,10,46055,0,4,9,DGHS_estimated
2024-01-17,12,46067,0,5,11,DGHS_estimated
2024-01-18,15,46082,0,7,14,DGHS_estimated
2024-01-19,7,46089,0,3,6,DGHS_estimated
2024-01-20,11,46100,0,5,10,DGHS_estimated
2024-01-21,10,46110,0,4,9,DGHS_estimated
2024-01-22,12,46122,0,7,11,DGHS_estimated
2024-01-23,12,46134,0,5,11,DGHS_estimated
2024-01-24,17,46151,0,7,16,DGHS_estimated
2024-01-25,15,46166,0,6,14,DGHS_estimated
2024-01-26,15,46181,0,8,14,DGHS_estimated
2024-01-27,12,46193,0,6,11,DGHS_estimated
2024-01-28,14,46207,0,7,13,DGHS_estimated
2024-01-29,17,46224,0,8,16,DGHS_estimated
2024-01-30,8,46232,0,3,7,DGHS_estimated
2024-01-31,14,46246,0,7,13,DGHS_estimated
2024-02-01,12,46258,0,5,11,DGHS_estimated
2024-02-02,11,46269,0,5,10,DGHS_estimated
2024-02-03,9,46278,0,3,8,DGHS_estimated
2024-02-04,12,46290,0,4,11,DGHS_estimated
2024-02-05,17,46307,0,8,16,DGHS_estimated
2024-02-06,6,46313,0,2,5,DGHS_estimated
2024-02-07,13,46326,0,7,12,DGHS_estimated
2024-02-08,6,46332,0,3,5,DGHS_estimated
2024-02-09,15,46347,0,7,14,DGHS_estimated
2024-02-10,7,46354,0,3,6,DGHS_estimated
2024-02-11,7,46361,0,3,6,DGHS_estimated
2024-02-12,9,46370,0,4,8,DGHS_estimated
2024-02-13,13,46383,0,7,12,DGHS_estimated
2024-02-14,9,46392,0,3,8,DGHS_estimated
2024-02-15,16,46408,0,7,15,DGHS_estimated
2024-02-16,14,46422,0,6,13,DGHS_estimated
2024-02-17,10,46432,0,5,9,DGHS_estimated
2024-02-18,17,46449,0,7,16,DGHS_estimated
2024-02-19,17,46466,0,9,16,DGHS_estimated
2024-02-20,7,46473,0,3,6,DGHS_estimated
2024-02-21,12,46485,0,6,11,DGHS_estimated
2024-02-22,13,46498,0,5,12,DGHS_estimated
2024-02-23,14,46512,0,7,13,DGHS_estimated
2024-02-24,16,46528,0,9,15,DGHS_estimated
2024-02-25,8,46536,0,3,7,DGHS_estimated
2024-02-26,7,46543,0,3,6,DGHS_estimated
2024-02-27,9,46552,0,4,8,DGHS_estimated
2024-02-28,10,46562,0,4,9,DGHS_estimated
2024-02-29,14,46576,0,6,13,DGHS_estimated
2024-03-01,17,46593,0,8,16,DGHS_estimated
2024-03-02,13,46606,0,5,12,DGHS_estimated
2024-03-03,8,46614,0,4,7,DGHS_estimated
2024-03-04,9,46623,0,4,8,DGHS_estimated
2024-03-05,10,46633,0,4,9,DGHS_estimated
2024-03-06,8,46641,0,3,7,DGHS_estimated
2024-03-07,9,46650,0,3,8,DGHS_estimated
2024-03-08,15,46665,0,7,14,DGHS_estimated
2024-03-09,17,46682,0,7,16,DGHS_estimated
2024-03-10,17,46699,0,7,16,DGHS_estimated
2024-03-11,13,46712,0,6,12,DGHS_estimated
2024-03-12,14,46726,0,7,13,DGHS_estimated
2024-03-13,10,46736,0,4,9,DGHS_estimated
2024-03-14,9,46745,0,5,8,DGHS_estimated
2024-03-15,11,46756,0,6,10,DGHS_estimated
2024-03-16,7,46763,0,3,6,DGHS_estimated
2024-03-17,17,46780,0,9,16,DGHS_estimated
2024-03-18,16,46796,0,8,15,DGHS_estimated
2024-03-19,9,46805,0,4,8,DGHS_estimated
2024-03-20,8,46813,0,4,7,DGHS_estimated
2024-03-21,16,46829,0,9,15,DGHS_estimated
2024-03-22,16,46845,0,7,15,DGHS_estimated
2024-03-23,6,46851,0,2,5,DGHS_estimated
2024-03-24,16,46867,0,6,15,DGHS_estimated
2024-03-25,10,46877,0,4,9,DGHS_estimated
2024-03-26,17,46894,0,9,16,DGHS_estimated
2024-03-27,15,46909,0,6,14,DGHS_estimated
2024-03-28,6,46915,0,2,5,DGHS_estimated
2024-03-29,10,46925,0,4,9,DGHS_estimated
2024-03-30,15,46940,0,6,14,DGHS_estimated
2024-03-31,12,46952,0,5,11,DGHS_estimated
2024-04-01,42,46994,0,20,40,DGHS_estimated
2024-04-02,32,47026,0,14,31,DGHS_estimated
2024-04-03,25,47051,0,13,24,DGHS_estimated
2024-04-04,27,47078,0,14,26,DGHS_estimated
2024-04-05,39,47117,0,15,37,DGHS_estimated
2024-04-06,29,47146,0,11,28,DGHS_estimated
2024-04-07,30,47176,0,13,29,DGHS_estimated
2024-04-08,44,47220,0,18,42,DGHS_estimated
2024-04-09,28,47248,0,11,26,DGHS_estimated
2024-04-10,39,47287,0,22,37,DGHS_estimated
2024-04-11,34,47321,0,19,32,DGHS_estimated
2024-04-12,19,47340,0,9,18,DGHS_estimated
2024-04-13,35,47375,0,20,33,DGHS_estimated
2024-04-14,35,47410,0,18,34,DGHS_estimated
2024-04-15,42,47452,0,21,40,DGHS_estimated
2024-04-16,42,47494,0,17,40,DGHS_estimated
2024-04-17,29,47523,0,14,27,DGHS_estimated
2024-04-18,37,47560,0,16,35,DGHS_estimated
2024-04-19,41,47601,0,22,39,DGHS_estimated
2024-04-20,24,47625,0,11,22,DGHS_estimated
2024-04-21,27,47652,0,14,26,DGHS_estimated
2024-04-22,26,47678,0,11,25,DGHS_estimated
2024-04-23,26,47704,0,12,24,DGHS_estimated
2024-04-24,23,47727,0,12,22,DGHS_estimated
2024-04-25,38,47765,0,21,37,DGHS_estimated
2024-04-26,32,47797,0,15,30,DGHS_estimated
2024-04-27,33,47830,0,17,31,DGHS_estimated
2024-04-28,22,47852,0,11,21,DGHS_estimated
2024-04-29,26,47878,0,12,25,DGHS_estimated
2024-04-30,28,47906,0,12,27,DGHS_estimated
2024-05-01,63,47969,0,31,60,DGHS_estimated
2024-05-02,59,48028,0,29,57,DGHS_estimated
2024-05-03,52,48080,0,30,49,DGHS_estimated
2024-05-04,45,48125,0,26,43,DGHS_estimated
2024-05-05,57,48182,0,24,55,DGHS_estimated
2024-05-06,39,48221,0,21,37,DGHS_estimated
2024-05-07,41,48262,0,19,39,DGHS_estimated
2024-05-08,27,48289,0,11,26,DGHS_estimated
2024-05-09,24,48313,0,13,23,DGHS_estimated
2024-05-10,34,48347,0,20,32,DGHS_estimated
2024-05-11,68,48415,0,27,66,DGHS_estimated
2024-05-12,59,48474,0,33,56,DGHS_estimated
2024-05-13,59,48533,0,27,57,DGHS_estimated
2024-05-14,54,48587,0,31,52,DGHS_estimated
2024-05-15,29,48616,0,14,28,DGHS_estimated
2024-05-16,56,48672,0,28,54,DGHS_estimated
2024-05-17,31,48703,0,15,29,DGHS_estimated
2024-05-18,61,48764,0,25,59,DGHS_estimated
2024-05-19,35,48799,0,14,33,DGHS_estimated
2024-05-20,27,48826,0,12,26,DGHS_estimated
2024-05-21,49,48875,0,22,47,DGHS_estimated
2024-05-22,59,48934,0,32,56,DGHS_estimated
2024-05-23,41,48975,0,20,39,DGHS_estimated
2024-05-24,68,49043,0,30,64,DGHS_estimated
2024-05-25,63,49106,0,34,60,DGHS_estimated
2024-05-26,54,49160,0,21,52,DGHS_estimated
2024-05-27,66,49226,0,27,63,DGHS_estimated
2024-05-28,45,49271,0,22,42,DGHS_estimated
2024-05-29,29,49300,0,17,28,DGHS_estimated
2024-05-30,59,49359,0,33,56,DGHS_estimated
2024-05-31,54,49413,0,29,52,DGHS_estimated
2024-06-01,85,49498,0,44,82,DGHS_estimated
2024-06-02,138,49636,0,61,131,DGHS_estimated
2024-06-03,57,49693,0,31,54,DGHS_estimated
2024-06-04,103,49796,0,45,100,DGHS_estimated
2024-06-05,86,49882,0,37,83,DGHS_estimated
2024-06-06,110,49992,0,54,105,DGHS_estimated
2024-06-07,126,50118,0,64,120,DGHS_estimated
2024-06-08,52,50170,0,28,49,DGHS_estimated
2024-06-09,116,50286,0,56,111,DGHS_estimated
2024-06-10,59,50345,0,34,57,DGHS_estimated
2024-06-11,54,50399,0,28,51,DGHS_estimated
2024-06-12,126,50525,0,67,123,DGHS_estimated
2024-06-13,108,50633,0,59,102,DGHS_estimated
2024-06-14,80,50713,0,47,76,DGHS_estimated
2024-06-15,133,50846,0,56,126,DGHS_estimated
2024-06-16,76,50922,0,37,72,DGHS_estimated
2024-06-17,121,51043,0,62,115,DGHS_estimated
2024-06-18,93,51136,0,53,90,DGHS_estimated
2024-06-19,106,51242,0,49,101,DGHS_estimated
2024-06-20,86,51328,0,51,82,DGHS_estimated
2024-06-21,122,51450,0,70,117,DGHS_estimated
2024-06-22,117,51567,0,50,114,DGHS_estimated
2024-06-23,93,51660,0,42,88,DGHS_estimated
2024-06-24,69,51729,0,38,67,DGHS_estimated
2024-06-25,118,51847,0,64,114,DGHS_estimated
2024-06-26,80,51927,0,43,77,DGHS_estimated
2024-06-27,122,52049,0,58,117,DGHS_estimated
2024-06-28,55,52104,0,30,53,DGHS_estimated
2024-06-29,57,52161,0,29,54,DGHS_estimated
2024-06-30,110,52271,0,64,104,DGHS_estimated
2024-07-01,93,52364,0,50,89,DGHS_estimated
2024-07-02,117,52481,0,60,114,DGHS_estimated
2024-07-03,142,52623,0,65,136,DGHS_estimated
2024-07-04,136,52759,0,78,131,DGHS_estimated
2024-07-05,158,52917,0,78,151,DGHS_estimated
2024-07-06,145,53062,0,62,139,DGHS_estimated
2024-07-07,133,53195,0,55,128,DGHS_estimated
2024-07-08,81,53276,0,32,79,DGHS_estimated
2024-07-09,105,53381,0,44,100,DGHS_estimated
2024-07-10,170,53551,0,99,162,DGHS_estimated
2024-07-11,163,53714,0,89,155,DGHS_estimated
2024-07-12,163,53877,0,67,155,DGHS_estimated
2024-07-13,112,53989,0,49,108,DGHS_estimated
2024-07-14,124,54113,0,68,120,DGHS_estimated
2024-07-15,136,54249,0,54,131,DGHS_estimated
2024-07-16,60,54309,0,25,57,DGHS_estimated
2024-07-17,139,54448,0,61,134,DGHS_estimated
2024-07-18,170,54618,0,100,162,DGHS_estimated
2024-07-19,105,54723,0,46,102,DGHS_estimated
2024-07-20,154,54877,0,67,149,DGHS_estimated
2024-07-21,171,55048,0,73,165,DGHS_estimated
2024-07-22,140,55188,0,61,135,DGHS_estimated
2024-07-23,60,55248,0,24,57,DGHS_estimated
2024-07-24,140,55388,0,74,137,DGHS_estimated
2024-07-25,131,55519,0,56,127,DGHS_estimated
2024-07-26,177,55696,0,73,168,DGHS_estimated
2024-07-27,113,55809,0,63,110,DGHS_estimated
2024-07-28,170,55979,0,98,161,DGHS_estimated
2024-07-29,165,56144,0,87,160,DGHS_estimated
2024-07-30,60,56204,0,25,57,DGHS_estimated
2024-07-31,113,56317,0,54,107,DGHS_estimated
2024-08-01,140,56457,0,80,135,DGHS_estimated
2024-08-02,212,56669,0,106,203,DGHS_estimated
2024-08-03,92,56761,0,43,88,DGHS_estimated
2024-08-04,82,56843,0,41,79,DGHS_estimated
2024-08-05,92,56935,0,41,88,DGHS_estimated
2024-08-06,106,57041,0,62,102,DGHS_estimated
2024-08-07,153,57194,0,77,146,DGHS_estimated
2024-08-08,187,57381,0,100,180,DGHS_estimated
2024-08-09,173,57554,0,75,165,DGHS_estimated
2024-08-10,111,57665,0,45,107,DGHS_estimated
2024-08-11,202,57867,0,88,193,DGHS_estimated
2024-08-12,96,57963,0,56,93,DGHS_estimated
2024-08-13,186,58149,0,74,181,DGHS_estimated
2024-08-14,97,58246,0,43,93,DGHS_estimated
2024-08-15,129,58375,0,67,126,DGHS_estimated
2024-08-16,212,58587,0,88,202,DGHS_estimated
2024-08-17,150,58737,0,82,146,DGHS_estimated
2024-08-18,193,58930,0,96,186,DGHS_estimated
2024-08-19,174,59104,0,93,169,DGHS_estimated
2024-08-20,199,59303,0,97,192,DGHS_estimated
2024-08-21,116,59419,0,51,111,DGHS_estimated
2024-08-22,157,59576,0,65,152,DGHS_estimated
2024-08-23,79,59655,0,39,75,DGHS_estimated
2024-08-24,176,59831,0,95,171,DGHS_estimated
2024-08-25,88,59919,0,45,84,DGHS_estimated
2024-08-26,172,60091,0,75,165,DGHS_estimated
2024-08-27,115,60206,0,57,112,DGHS_estimated
2024-08-28,98,60304,0,43,95,DGHS_estimated
2024-08-29,185,60489,0,107,178,DGHS_estimated
2024-08-30,176,60665,0,87,169,DGHS_estimated
2024-08-31,101,60766,0,47,98,DGHS_estimated
2024-09-01,142,60908,0,83,135,DGHS_estimated
2024-09-02,196,61104,0,92,187,DGHS_estimated
2024-09-03,185,61289,0,109,178,DGHS_estimated
2024-09-04,161,61450,0,88,155,DGHS_estimated
2024-09-05,87,61537,0,37,83,DGHS_estimated
2024-09-06,189,61726,0,96,180,DGHS_estimated
2024-09-07,171,61897,0,85,163,DGHS_estimated
2024-09-08,116,62013,0,66,112,DGHS_estimated
2024-09-09,117,62130,0,52,112,DGHS_estimated
2024-09-10,99,62229,0,52,94,DGHS_estimated
2024-09-11,158,62387,0,91,150,DGHS_estimated
2024-09-12,168,62555,0,84,161,DGHS_estimated
2024-09-13,136,62691,0,55,130,DGHS_estimated
2024-09-14,108,62799,0,44,103,DGHS_estimated
2024-09-15,139,62938,0,74,132,DGHS_estimated
2024-09-16,231,63169,0,135,223,DGHS_estimated
2024-09-17,183,63352,0,81,174,DGHS_estimated
2024-09-18,201,63553,0,106,193,DGHS_estimated
2024-09-19,230,63783,0,101,224,DGHS_estimated
2024-09-20,241,64024,0,124,229,DGHS_estimated
2024-09-21,117,64141,0,56,112,DGHS_estimated
2024-09-22,103,64244,0,53,97,DGHS_estimated
2024-09-23,133,64377,0,55,129,DGHS_estimated
2024-09-24,132,64509,0,68,125,DGHS_estimated
2024-09-25,124,64633,0,61,119,DGHS_estimated
2024-09-26,142,64775,0,84,135,DGHS_estimated
2024-09-27,140,64915,0,77,136,DGHS_estimated
2024-09-28,134,65049,0,57,128,DGHS_estimated
2024-09-29,156,65205,0,90,149,DGHS_estimated
2024-09-30,184,65389,0,106,175,DGHS_estimated
2024-10-01,66,65455,0,36,63,DGHS_estimated
2024-10-02,35,65490,0,14,34,DGHS_estimated
2024-10-03,26,65516,0,12,25,DGHS_estimated
2024-10-04,66,65582,0,30,63,DGHS_estimated
2024-10-05,26,65608,0,12,25,DGHS_estimated
2024-10-06,36,65644,0,18,34,DGHS_estimated
2024-10-07,27,65671,0,14,25,DGHS_estimated
2024-10-08,69,65740,0,37,67,DGHS_estimated
2024-10-09,64,65804,0,37,61,DGHS_estimated
2024-10-10,28,65832,0,14,27,DGHS_estimated
2024-10-11,54,65886,0,32,51,DGHS_estimated
2024-10-12,37,65923,0,18,35,DGHS_estimated
2024-10-13,67,65990,0,30,65,DGHS_estimated
2024-10-14,68,66058,0,34,65,DGHS_estimated
2024-10-15,33,66091,0,15,31,DGHS_estimated
2024-10-16,68,66159,0,38,64,DGHS_estimated
2024-10-17,28,66187,0,14,26,DGHS_estimated
2024-10-18,48,66235,0,28,45,DGHS_estimated
2024-10-19,66,66301,0,28,63,DGHS_estimated
2024-10-20,43,66344,0,24,41,DGHS_estimated
2024-10-21,41,66385,0,16,40,DGHS_estimated
2024-10-22,68,66453,0,28,66,DGHS_estimated
2024-10-23,27,66480,0,10,26,DGHS_estimated
2024-10-24,52,66532,0,24,50,DGHS_estimated
2024-10-25,28,66560,0,13,27,DGHS_estimated
2024-10-26,47,66607,0,25,45,DGHS_estimated
2024-10-27,25,66632,0,10,24,DGHS_estimated
2024-10-28,70,66702,0,32,67,DGHS_estimated
2024-10-29,31,66733,0,14,29,DGHS_estimated
2024-10-30,69,66802,0,30,67,DGHS_estimated
2024-10-31,32,66834,0,14,30,DGHS_estimated
2024-11-01,25,66859,0,10,24,DGHS_estimated
2024-11-02,15,66874,0,7,14,DGHS_estimated
2024-11-03,40,66914,0,20,38,DGHS_estimated
2024-11-04,23,66937,0,11,22,DGHS_estimated
2024-11-05,27,66964,0,13,26,DGHS_estimated
2024-11-06,29,66993,0,13,27,DGHS_estimated
2024-11-07,25,67018,0,10,24,DGHS_estimated
2024-11-08,39,67057,0,20,37,DGHS_estimated
2024-11-09,21,67078,0,10,20,DGHS_estimated
2024-11-10,16,67094,0,6,15,DGHS_estimated
2024-11-11,41,67135,0,16,38,DGHS_estimated
2024-11-12,39,67174,0,18,37,DGHS_estimated
2024-11-13,24,67198,0,10,23,DGHS_estimated
2024-11-14,16,67214,0,6,15,DGHS_estimated
2024-11-15,18,67232,0,7,17,DGHS_estimated
2024-11-16,26,67258,0,11,24,DGHS_estimated
2024-11-17,19,67277,0,9,18,DGHS_estimated
2024-11-18,29,67306,0,13,28,DGHS_estimated
2024-11-19,44,67350,0,23,43,DGHS_estimated
2024-11-20,25,67375,0,14,24,DGHS_estimated
2024-11-21,39,67414,0,20,37,DGHS_estimated
2024-11-22,44,67458,0,20,43,DGHS_estimated
2024-11-23,32,67490,0,16,30,DGHS_estimated
2024-11-24,42,67532,0,22,40,DGHS_estimated
2024-11-25,36,67568,0,15,35,DGHS_estimated
2024-11-26,36,67604,0,19,34,DGHS_estimated
2024-11-27,18,67622,0,7,17,DGHS_estimated
2024-11-28,35,67657,0,17,33,DGHS_estimated
2024-11-29,43,67700,0,21,42,DGHS_estimated
2024-11-30,17,67717,0,8,16,DGHS_estimated
2024-12-01,11,67728,0,4,10,DGHS_estimated
2024-12-02,17,67745,0,7,16,DGHS_estimated
2024-12-03,16,67761,0,8,15,DGHS_estimated
2024-12-04,7,67768,0,3,6,DGHS_estimated
2024-12-05,13,67781,0,5,12,DGHS_estimated
2024-12-06,14,67795,0,7,13,DGHS_estimated
2024-12-07,15,67810,0,8,14,DGHS_estimated
2024-12-08,11,67821,0,5,10,DGHS_estimated
2024-12-09,16,67837,0,8,15,DGHS_estimated
2024-12-10,17,67854,0,7,16,DGHS_estimated
2024-12-11,8,67862,0,4,7,DGHS_estimated
2024-12-12,17,67879,0,8,16,DGHS_estimated
2024-12-13,11,67890,0,4,10,DGHS_estimated
2024-12-14,8,67898,0,3,7,DGHS_estimated
2024-12-15,11,67909,0,4,10,DGHS_estimated
2024-12-16,15,67924,0,7,14,DGHS_estimated
2024-12-17,16,67940,0,6,15,DGHS_estimated
2024-12-18,6,67946,0,2,5,DGHS_estimated
2024-12-19,8,67954,0,3,7,DGHS_estimated
2024-12-20,6,67960,0,3,5,DGHS_estimated
2024-12-21,8,67968,0,4,7,DGHS_estimated
2024-12-22,10,67978,0,4,9,DGHS_estimated
2024-12-23,7,67985,0,3,6,DGHS_estimated
2024-12-24,12,67997,0,6,11,DGHS_estimated
2024-12-25,15,68012,0,8,14,DGHS_estimated
2024-12-26,12,68024,0,5,11,DGHS_estimated
2024-12-27,17,68041,0,8,16,DGHS_estimated
2024-12-28,11,68052,0,4,10,DGHS_estimated
2024-12-29,17,68069,0,8,16,DGHS_estimated
2024-12-30,10,68079,0,4,9,DGHS_estimated
2024-12-31,8,68087,0,3,7,DGHS_estimated
